5,5
p 1 1 1 p
1 0 0 0 1
1 0 c 0 1
1 0 0 0 1
p 1 1 1 p